1001 1 0
1002 1 0
1003 1 0
1004 1 0
1005 2 0
2001 2 0
2002 2 0
2003 2 0
2004 2 0
2005 2 0
2006 2 0
3001 3 0
3002 3 0
3003 3 0
3004 4 0
3005 4 0
